# _ 1 2
#  3 0 4
# _ 5 6 7
#  _ 8 9

0 0 1 1 2 3 4 5 6 ; 1 1
1 1 1 2 0 3 ; 1 0 
2 1 1 1 0 4 ; 2 0
3 1 1 1 0 5 ; 0 1
4 1 1 2 0 6 ; 2 1
5 1 1 3 0 6 8 ; 1 2
6 2 1 0 4 7 9 8 5 ; 2 2
7 3 1 4 6 9 ; 3 2
8 3 1 5 6 9 ; 1 3
9 3 1 6 7 8 ; 2 3
