# _ 1 2
#  3 0 4
# _ 5 6

0 0 1 1 2 3 4 5 6 ; 1 1
1 1 1 2 0 3 ; 1 0 
2 1 1 1 0 4 ; 2 0
3 1 1 1 0 5 ; 0 1
4 1 1 2 0 6 ; 2 1
5 1 1 3 0 6 ; 1 2
6 1 1 4 0 5 ; 2 2
